13
15
##-###---###--#
#---#--#-----#-
#-#-#-##-#-##-#
#-#------#----#
#-###-#-##-#--e
#--#--#-#--####
#-#-##----#---#
#---#-###---#-#
##--#-##----#--
#---#-#---#-#-#
#--#-#--##---#-
##-----#--#-#-#
s--##-###-##-#-